##############################################
#                                            #
#          ###                #####          #
#          ###                               #
#          #                       X         #
#                   ########                 #
#                                            #
#                                            #
#        VVVVVV  VVVVV  V   V  V   V         #
#          VV    V   V  V V V    V           #
#          VV    VVVVV  V   V    V           #
#                                            #
##############################################