######################################
#              VVVVVVVV              #
#     ###                #####       #
#     ###                            #
#     #V                      X      #
#              ########              #
#              ########              #
#                V##V                #
#                                    #
#                                    #
#    VVVVVV  VVVVV  V   V  V   V     #
#      VV    V   V  VV  V   VVV      #
#      VV    V   V  V V V    V       #
#      VV    VVVVV  V  VV    V       #
#                                    #
######################################