######################################
#              VVVVVVVV              #
#     ###                BBBBB       #
#     ###                            #
#     #V                      X      #
#B             ########              #
#B              ######               #
#B               V##V                #
#BB                                  #
#BB                                  #
#    VVVVVV  VVVVV  V   V  V   V     #
#      VV    V   V  VV  V   VVV      #
#      VV    V   V  V V V    V       #
#      VV    VVVVV  V  VV    V     BB#
#                                  BB#
######################################