######################################
#              VVVVVVVV              #
#     ###                BBBBB       #
#     ###                            #
#     #V                             #
#B             ########              #
#B              ######               #
#B               V##V                R
#BB                                 XR
#BB                                  #
#    VVVVVV  VVVVV  V   V  V   V     #
#      VV    V   V  VV  V   VVV      #
#      VV    V   V  V V V    V       #
#      VV    VVVVV  V  VV    V     BB#
#                                  BB#
######################################