######################################
#              VVVVVVVV              #
#     ###                BBBBB       #
#     ###                            #
#     #V                             #
#B             ########       X      #
#B              ######               #
#B               V##V                R
#BB                                  R
#BB                                  #
#    VVVVVV  VVVVV  V   V  V   V     #
#      VV    V   V  VV  V   VVV      #
#      VV    V   V  V V V    V       #
#      VV    VVVVV  V  VV    V     BB#
#                                  BB#
######################################