######################################
#                                    #
#    BBBBBBBBBBBBBBBBBBBBBBBB        #
#    BB                              #
#    BB       VVVVVVV                #
#    BB       VVVVVVVVV              #
#    BBBBBBBBBBBBBBBBBBBBBBBB        #
L                                    #
LX                                   #
#       VVVVV  VVVVV  VVV   VV       #
#          VV  VV     VV VV VV       #
#          VV  VVVV   VV  VVVV       #
#          VV  VV     VV    VV       #
#       VVVVV  VVVVV  VV    VV       #
#                                    #
##################DD##################