######################################
#                                    #
#    BBBBBBBBBBBBBBBBBBBBBBBB        #
#    BB                              #
#    BB       VVVVVVV                #
#    BB       VVVVVVVVV              #
#    BBBBBBBBBBBBBBBBBBBBBBBB        #
L                                    #
L                                    #
#      VVVVVV  VVVVV  VVV   VV       #
#          VV  VV     VV VV VV       #
#          VV  VVVV   VV  VVVV       #
#          VV  VV     VV    VV       #
#       VVVVV  VVVVV  VV    VV       #
#                                    #
######################################