ground:ground2
######################################
#WWWWWWWWWWWWWWWWWWWWWWWWWWWWWWWWWWWW#
#    BBBBBBBBBBBBBBBBBBBBBBBB       W#
#    BB                             W#
#    BB       VVVVVVV               W#
#    BB       VVVVVVVVV             W#
#    BBBBBBBBBBBBBBBBBBBBBBBB       W#
L                                   W#
L X                                 W#
#       VVVVV  VVVVV  VV   V        W#
#          VV  VV     V V  V        W#
#          VV  VVVV   V  V V        W#
#          VV  VV     V   VV        W#
#       VVVVV  VVVVV  V    V        W#
#                                   W#
##################DD##################