##################UU##################
#                 X                  #
#     VVVV                           #
#     VVVV                           #
#                                    #
#B             VVVVVVVV              #
#B              VVVVVV               #
#B               VVVV                #
#BB               VV                 #
#BB                                  #
#        BBBBB  BBBBB  BBBBB         #
#        BWWWB  BWWWB  BWWWB         #
#        BBBB   BWWWB  BWWWB         #
#        B      BBBBB  BBBBB         #
#                                  VV#
######################################