##################UU##################
#                 X                  #
#     VVVV                           #
#     VVVV                           #
#                                    #
#B             VVVVVVVV              #
#B              VVVVVV               #
#B               VVVV                #
#BB               VV                 #
#BB                                  #
#        BBBBB  BBBBB  BBBBB         #
#        B   B  B   B  B   B         #
#        BBBB   B   B  B   B         #
#        B      BBBBB  BBBBB         #
#                                  VV#
######################################